0000000000000000000000000
0011111100000000000000000
0010000100000000000000000
0011100110000000000020000
0002100011000000000000000
0000100001000000000000000
1100110111000000000000000
0110010100000000011100000
0011010111100111110111111
0001110000100100000000000
0000000000110100000000000
0000000000011100200000000
0002000000000000000020000
0000000000000000000000000