0000000000000000000000000
0000000000000000000002000
0011110000002000000000000
0012010000000000000000000
0010010111111111000000000
0110010100000001000000000
1100110100111111000000000
0011100112100000000000000
0010200010111111001111111
0011111110000001001000000
0000000000021111001000000
0000000000001000001000000
0000000000001111111000000
0000000000000000000000000