0111111100000000000000000
0100000111100000000000000
0111111000110000000000000
0002001110011100000000000
0111100010000100000000000
0100110110001100020000000
1100210100001000000000000
0000011100001100000000000
0000000000000100000001111
0000200000000111110001000
0000000000000000010001000
0000000000000000011111000
0000000200000000000000000
0000000000000000000000000