0000000000000000000000000
0000000111111100000000000
0000000100200100000000000
0000000111100110000000000
0000000000102010001111000
0000000001100010001001000
1111111111000012001001000
0000000000000010201001020
0000000000000010021001111
0000000111111110001000000
0000000122200000001000000
0000000111111111111000000
0000000000000000000000000
0000000000000000000000000