0000000000000000000000000
0011111100000000000000000
0010000100000000000000000
0011100110000000000020000
0002100011110000000000000
0000100000011100000000000
1100110000000100000000000
0110010000011100011100000
0011010000010011110111111
0001110000110110000000000
0200020000100100000000000
0002000000111100200000000
2000002000000000000020000
0222220000000000000000000